1111111111111
1001111C11111
10010000000C1
10010000000C1
10P00100000C1
11C111E001111
1111111111111