1111111111111111111111111111111111111111111111111111111111111111111111111111
1P11111111111111111111111111111111111111111111111111111111111111111111111111
1C11111111111111111111111111111111111111111111111111111111111111111111111111
1E11111111111111111111111111111111111111111111111111111111111111111111111111
1111111111111111111111111111111111111111111111111111111111111111111111111111