111111
1PCE11
111111
111C11
111111