11111111111111
10011111C11111
100100000000C1
100100100000C1
10P001100000C1
11C11111E11111
11111111111111