11111111111111
10011111C11111
100100000000C1
100100000000C1
10P0011E0000C1
11111111111111

